trivial, nontrivial, cycles, bl, routed, usage
15, 20, 259, 7, 13, 0.250000
15, 20, 259, 7, 13, 0.250000
18, 17, 213, 7, 10, 0.236111
18, 17, 218, 8, 9, 0.215278
18, 17, 218, 8, 9, 0.215278
20, 15, 227, 6, 9, 0.250000
19, 16, 171, 5, 11, 0.284722
22, 13, 154, 4, 9, 0.277778
18, 17, 210, 5, 12, 0.277778
18, 17, 213, 7, 10, 0.256944
18, 17, 219, 7, 10, 0.236111
18, 17, 219, 7, 10, 0.236111
14, 21, 276, 8, 13, 0.250000
14, 21, 276, 8, 13, 0.250000
14, 21, 276, 8, 13, 0.250000
20, 15, 248, 6, 9, 0.270833
23, 12, 208, 6, 6, 0.256944
19, 16, 223, 4, 12, 0.312500
19, 16, 221, 6, 10, 0.284722
17, 18, 278, 9, 9, 0.222222
14, 21, 248, 7, 14, 0.277778
14, 21, 248, 7, 14, 0.277778
22, 13, 174, 6, 7, 0.250000
22, 13, 174, 6, 7, 0.250000
22, 13, 174, 6, 7, 0.250000
18, 17, 206, 8, 9, 0.222222
20, 15, 249, 6, 9, 0.305556
19, 16, 202, 6, 10, 0.270833
19, 16, 185, 5, 11, 0.312500
20, 15, 215, 5, 10, 0.312500
17, 18, 230, 6, 12, 0.270833
17, 18, 236, 6, 12, 0.284722
13, 22, 311, 8, 14, 0.263889
13, 22, 311, 8, 14, 0.263889
13, 22, 311, 8, 14, 0.263889
16, 19, 283, 5, 14, 0.319444
19, 16, 219, 7, 9, 0.263889
24, 11, 160, 5, 6, 0.222222
20, 15, 208, 8, 7, 0.243056
17, 18, 206, 8, 10, 0.215278
17, 18, 210, 8, 10, 0.222222
18, 17, 227, 8, 9, 0.250000
17, 18, 245, 9, 9, 0.236111
17, 18, 245, 9, 9, 0.236111
21, 14, 188, 6, 8, 0.256944
21, 14, 155, 7, 7, 0.229167
22, 13, 230, 4, 9, 0.305556
19, 16, 188, 4, 12, 0.305556
16, 19, 242, 11, 8, 0.208333
19, 16, 220, 3, 13, 0.305556
19, 16, 220, 3, 13, 0.305556
22, 13, 178, 5, 8, 0.256944
22, 13, 178, 5, 8, 0.256944
22, 13, 178, 5, 8, 0.256944
22, 13, 173, 5, 8, 0.250000
20, 15, 183, 5, 10, 0.256944
24, 11, 180, 5, 6, 0.236111
20, 15, 175, 5, 10, 0.250000
20, 15, 191, 6, 9, 0.243056
18, 17, 196, 6, 11, 0.270833
18, 17, 213, 7, 10, 0.256944
18, 17, 213, 7, 10, 0.256944
20, 15, 205, 5, 10, 0.263889
19, 16, 205, 5, 11, 0.277778
16, 19, 260, 7, 12, 0.277778
21, 14, 177, 7, 7, 0.236111
23, 12, 187, 5, 7, 0.270833
23, 12, 187, 5, 7, 0.270833
19, 16, 203, 5, 11, 0.291667
19, 16, 203, 5, 11, 0.291667
19, 16, 203, 5, 11, 0.291667
22, 13, 204, 5, 8, 0.256944
24, 11, 226, 7, 4, 0.215278
19, 16, 229, 4, 12, 0.305556
21, 14, 199, 4, 10, 0.284722
18, 17, 287, 8, 9, 0.236111
17, 18, 232, 5, 13, 0.291667
16, 19, 252, 6, 13, 0.277778
18, 17, 238, 6, 11, 0.305556
18, 17, 234, 6, 11, 0.298611
18, 17, 234, 6, 11, 0.298611
21, 14, 165, 6, 8, 0.222222
19, 16, 254, 8, 8, 0.250000
20, 15, 244, 4, 11, 0.305556
21, 14, 196, 4, 10, 0.298611
19, 16, 228, 5, 11, 0.312500
20, 15, 202, 5, 10, 0.270833
20, 15, 202, 5, 10, 0.270833
17, 18, 238, 7, 11, 0.284722
17, 18, 238, 7, 11, 0.284722
17, 18, 238, 7, 11, 0.284722
16, 19, 236, 6, 13, 0.277778
19, 16, 41, 0, 3, 0.180556
17, 18, 205, 7, 11, 0.229167
23, 12, 187, 3, 9, 0.319444
20, 15, 37, 2, 1, 0.138889
21, 14, 180, 4, 10, 0.284722
21, 14, 180, 4, 10, 0.284722
19, 16, 222, 6, 10, 0.263889
19, 16, 222, 6, 10, 0.263889
19, 16, 222, 6, 10, 0.263889
22, 13, 190, 4, 9, 0.277778
23, 12, 174, 6, 6, 0.243056
21, 14, 175, 4, 10, 0.270833
22, 13, 179, 5, 8, 0.256944
20, 15, 231, 7, 8, 0.229167
19, 16, 218, 6, 10, 0.250000
19, 16, 218, 6, 10, 0.250000
16, 19, 226, 6, 13, 0.270833
16, 19, 226, 6, 13, 0.270833
16, 19, 226, 6, 13, 0.270833
20, 15, 207, 5, 10, 0.284722
25, 10, 157, 5, 5, 0.250000
22, 13, 150, 3, 10, 0.284722
21, 14, 199, 5, 9, 0.250000
20, 15, 230, 10, 5, 0.187500
21, 14, 193, 3, 11, 0.298611
21, 14, 193, 3, 11, 0.298611
19, 16, 210, 5, 11, 0.291667
19, 16, 210, 5, 11, 0.291667
19, 16, 210, 5, 11, 0.291667
20, 15, 234, 6, 9, 0.256944
21, 14, 181, 4, 10, 0.284722
21, 14, 191, 3, 11, 0.291667
21, 14, 191, 5, 9, 0.256944
19, 16, 191, 3, 13, 0.284722
19, 16, 191, 3, 13, 0.284722
23, 12, 175, 5, 7, 0.250000
23, 12, 175, 5, 7, 0.250000
23, 12, 175, 5, 7, 0.250000
20, 15, 225, 6, 9, 0.243056
20, 15, 183, 7, 8, 0.215278
20, 15, 215, 5, 10, 0.277778
22, 13, 159, 5, 8, 0.229167
19, 16, 190, 5, 11, 0.250000
19, 16, 198, 6, 10, 0.270833
19, 16, 198, 6, 10, 0.270833
19, 16, 214, 7, 9, 0.243056
19, 16, 214, 7, 9, 0.243056
19, 16, 214, 7, 9, 0.243056
19, 16, 210, 9, 7, 0.208333
22, 13, 171, 3, 10, 0.291667
21, 14, 161, 3, 11, 0.270833
18, 17, 251, 9, 8, 0.222222
18, 17, 59, 0, 5, 0.208333
18, 17, 59, 0, 5, 0.208333
17, 18, 230, 6, 12, 0.270833
17, 18, 227, 7, 11, 0.250000
17, 18, 227, 7, 11, 0.250000
21, 14, 198, 7, 7, 0.222222
22, 13, 192, 7, 6, 0.256944
20, 15, 262, 7, 8, 0.243056
21, 14, 204, 5, 9, 0.270833
18, 17, 241, 7, 10, 0.243056
14, 21, 271, 6, 15, 0.312500
14, 21, 271, 6, 15, 0.312500
15, 20, 277, 8, 12, 0.236111
15, 20, 277, 8, 12, 0.236111
15, 20, 277, 8, 12, 0.236111
16, 19, 246, 6, 13, 0.298611
18, 17, 204, 9, 8, 0.208333
22, 13, 210, 5, 8, 0.263889
22, 13, 194, 7, 6, 0.208333
20, 15, 225, 6, 9, 0.236111
20, 15, 225, 6, 9, 0.236111
15, 20, 243, 9, 11, 0.236111
15, 20, 243, 9, 11, 0.236111
15, 20, 243, 9, 11, 0.236111
19, 16, 225, 7, 9, 0.236111
21, 14, 177, 4, 10, 0.284722
15, 20, 266, 5, 15, 0.326389
20, 15, 191, 6, 9, 0.256944
20, 15, 224, 4, 11, 0.305556
20, 15, 224, 4, 11, 0.305556
15, 20, 225, 8, 12, 0.236111
15, 20, 225, 8, 12, 0.236111
15, 20, 225, 8, 12, 0.236111
18, 17, 232, 5, 12, 0.347222
21, 14, 223, 6, 8, 0.284722
21, 14, 202, 4, 10, 0.326389
16, 19, 257, 6, 13, 0.277778
22, 13, 182, 4, 9, 0.270833
20, 15, 183, 2, 13, 0.312500
20, 15, 183, 2, 13, 0.312500
18, 17, 213, 6, 11, 0.243056
18, 17, 213, 6, 11, 0.243056
18, 17, 213, 6, 11, 0.243056
18, 17, 260, 7, 10, 0.256944
23, 12, 156, 7, 5, 0.208333
24, 11, 153, 1, 10, 0.326389
19, 16, 199, 4, 12, 0.298611
17, 18, 270, 8, 10, 0.229167
19, 16, 203, 5, 11, 0.263889
19, 16, 203, 5, 11, 0.263889
22, 13, 207, 4, 9, 0.284722
22, 13, 207, 4, 9, 0.284722
22, 13, 207, 4, 9, 0.284722
16, 19, 276, 6, 13, 0.284722
20, 15, 198, 8, 7, 0.236111
17, 18, 249, 5, 13, 0.312500
21, 14, 195, 4, 10, 0.305556
18, 17, 243, 9, 8, 0.215278
17, 18, 59, 0, 5, 0.201389
17, 18, 59, 0, 5, 0.201389
19, 16, 227, 7, 9, 0.229167
19, 16, 227, 7, 9, 0.229167
19, 16, 227, 7, 9, 0.229167
21, 14, 180, 5, 9, 0.270833
24, 11, 176, 7, 4, 0.208333
18, 17, 254, 6, 11, 0.263889
22, 13, 228, 7, 6, 0.208333
18, 17, 234, 8, 9, 0.229167
16, 19, 59, 0, 5, 0.194444
16, 19, 59, 0, 5, 0.194444
20, 15, 222, 6, 9, 0.243056
20, 15, 222, 6, 9, 0.243056
20, 15, 222, 6, 9, 0.243056
22, 13, 187, 7, 6, 0.222222
22, 13, 185, 7, 6, 0.236111
17, 18, 299, 6, 12, 0.277778
17, 18, 272, 8, 10, 0.229167
18, 17, 228, 7, 10, 0.256944
19, 16, 211, 5, 11, 0.291667
19, 16, 211, 5, 11, 0.291667
17, 18, 218, 6, 12, 0.263889
17, 18, 218, 6, 12, 0.263889
17, 18, 218, 6, 12, 0.263889
19, 16, 243, 7, 9, 0.236111
18, 17, 207, 5, 12, 0.270833
19, 16, 222, 5, 11, 0.291667
21, 14, 183, 4, 10, 0.284722
15, 20, 238, 5, 15, 0.305556
15, 20, 238, 5, 15, 0.305556
15, 20, 248, 6, 14, 0.263889
15, 20, 248, 6, 14, 0.263889
15, 20, 248, 6, 14, 0.263889
17, 18, 218, 6, 12, 0.263889
17, 18, 245, 9, 9, 0.229167
21, 14, 220, 5, 9, 0.270833
21, 14, 234, 7, 7, 0.263889
18, 17, 231, 4, 13, 0.298611
18, 17, 231, 4, 13, 0.298611
17, 18, 238, 7, 11, 0.270833
17, 18, 243, 7, 11, 0.263889
17, 18, 243, 7, 11, 0.263889
17, 18, 266, 6, 12, 0.277778
21, 14, 181, 3, 11, 0.326389
22, 13, 154, 2, 11, 0.319444
21, 14, 201, 6, 8, 0.243056
18, 17, 258, 7, 10, 0.250000
18, 17, 291, 8, 9, 0.222222
16, 19, 254, 7, 12, 0.250000
16, 19, 254, 7, 12, 0.250000
16, 19, 254, 7, 12, 0.250000
19, 16, 234, 7, 9, 0.236111
19, 16, 206, 4, 12, 0.298611
15, 20, 247, 8, 12, 0.243056
18, 17, 267, 8, 9, 0.208333
17, 18, 208, 5, 13, 0.277778
17, 18, 218, 6, 12, 0.256944
14, 21, 272, 10, 11, 0.229167
14, 21, 272, 10, 11, 0.229167
14, 21, 272, 10, 11, 0.229167
22, 13, 175, 4, 9, 0.277778
18, 17, 212, 8, 9, 0.256944
21, 14, 190, 4, 10, 0.250000
20, 15, 177, 5, 10, 0.263889
16, 19, 279, 8, 11, 0.291667
17, 18, 225, 5, 13, 0.298611
17, 18, 221, 6, 12, 0.256944
17, 18, 236, 7, 11, 0.256944
17, 18, 225, 8, 10, 0.236111
17, 18, 225, 8, 10, 0.236111
19, 16, 224, 6, 10, 0.270833
18, 17, 247, 8, 9, 0.263889
19, 16, 264, 5, 11, 0.284722
23, 12, 170, 4, 8, 0.277778
18, 17, 256, 8, 9, 0.243056
22, 13, 200, 5, 8, 0.270833
22, 13, 200, 5, 8, 0.270833
19, 16, 188, 6, 10, 0.263889
19, 16, 188, 6, 10, 0.263889
19, 16, 188, 6, 10, 0.263889
21, 14, 225, 3, 11, 0.326389
21, 14, 224, 9, 5, 0.201389
17, 18, 209, 3, 15, 0.319444
19, 16, 217, 4, 12, 0.340278
18, 17, 288, 8, 9, 0.243056
14, 21, 261, 8, 13, 0.250000
14, 21, 261, 8, 13, 0.250000
23, 12, 178, 6, 6, 0.222222
23, 12, 178, 6, 6, 0.222222
23, 12, 178, 6, 6, 0.222222
23, 12, 180, 5, 7, 0.263889
20, 15, 194, 7, 8, 0.291667
20, 15, 234, 5, 10, 0.319444
18, 17, 183, 6, 11, 0.277778
15, 20, 278, 6, 14, 0.284722
23, 12, 180, 4, 8, 0.284722
23, 12, 180, 4, 8, 0.284722
18, 17, 187, 6, 11, 0.256944
18, 17, 187, 6, 11, 0.256944
18, 17, 187, 6, 11, 0.256944
22, 13, 212, 4, 9, 0.277778
21, 14, 202, 9, 5, 0.194444
18, 17, 202, 4, 13, 0.284722
19, 16, 223, 5, 11, 0.277778
18, 17, 258, 7, 10, 0.250000
18, 17, 196, 5, 12, 0.277778
18, 17, 196, 5, 12, 0.277778
17, 18, 216, 7, 11, 0.256944
17, 18, 216, 7, 11, 0.256944
17, 18, 216, 7, 11, 0.256944
20, 15, 219, 5, 10, 0.263889
18, 17, 208, 7, 10, 0.243056
22, 13, 200, 6, 7, 0.236111
19, 16, 185, 4, 12, 0.270833
17, 18, 276, 8, 10, 0.263889
16, 19, 232, 4, 15, 0.305556
16, 19, 232, 4, 15, 0.305556
26, 9, 141, 3, 6, 0.256944
26, 9, 141, 3, 6, 0.256944
26, 9, 141, 3, 6, 0.256944
17, 18, 229, 8, 10, 0.229167
21, 14, 221, 7, 7, 0.256944
22, 13, 198, 4, 9, 0.277778
20, 15, 158, 5, 10, 0.277778
18, 17, 222, 6, 11, 0.256944
20, 15, 182, 4, 11, 0.298611
20, 15, 182, 4, 11, 0.298611
18, 17, 218, 8, 9, 0.229167
18, 17, 218, 8, 9, 0.229167
18, 17, 218, 8, 9, 0.229167
21, 14, 220, 6, 8, 0.243056
18, 17, 210, 7, 10, 0.284722
22, 13, 162, 5, 8, 0.229167
19, 16, 179, 3, 13, 0.291667
16, 19, 267, 9, 10, 0.256944
16, 19, 237, 5, 14, 0.298611
16, 19, 237, 5, 14, 0.298611
16, 19, 231, 8, 11, 0.256944
16, 19, 231, 8, 11, 0.256944
16, 19, 231, 8, 11, 0.256944
23, 12, 175, 5, 7, 0.250000
17, 18, 210, 8, 10, 0.236111
20, 15, 203, 4, 11, 0.263889
20, 15, 168, 4, 11, 0.277778
18, 17, 270, 8, 9, 0.250000
15, 20, 231, 4, 16, 0.333333
15, 20, 231, 4, 16, 0.333333
14, 21, 255, 6, 15, 0.291667
14, 21, 255, 6, 15, 0.291667
14, 21, 255, 6, 15, 0.291667
16, 19, 229, 5, 14, 0.298611
19, 16, 218, 8, 8, 0.250000
22, 13, 200, 4, 9, 0.277778
23, 12, 173, 7, 5, 0.201389
19, 16, 192, 6, 10, 0.263889
19, 16, 192, 6, 10, 0.263889
18, 17, 218, 5, 12, 0.312500
18, 17, 218, 5, 12, 0.312500
18, 17, 218, 5, 12, 0.312500
21, 14, 176, 4, 10, 0.263889
19, 16, 217, 5, 11, 0.277778
19, 16, 182, 6, 10, 0.236111
20, 15, 206, 5, 10, 0.256944
20, 15, 206, 5, 10, 0.256944
16, 19, 241, 6, 13, 0.263889
16, 19, 241, 6, 13, 0.263889
16, 19, 241, 6, 13, 0.263889
19, 16, 213, 6, 10, 0.263889
23, 12, 152, 5, 7, 0.229167
19, 16, 231, 5, 11, 0.291667
19, 16, 194, 4, 12, 0.284722
19, 16, 259, 6, 10, 0.263889
18, 17, 201, 5, 12, 0.326389
18, 17, 180, 5, 12, 0.277778
21, 14, 210, 5, 9, 0.270833
21, 14, 210, 5, 9, 0.270833
21, 14, 210, 5, 9, 0.270833
23, 12, 176, 6, 6, 0.236111
21, 14, 174, 8, 6, 0.208333
19, 16, 282, 7, 9, 0.284722
18, 17, 211, 4, 13, 0.298611
17, 18, 240, 7, 11, 0.256944
21, 14, 177, 4, 10, 0.284722
21, 14, 177, 4, 10, 0.284722
13, 22, 286, 6, 16, 0.333333
13, 22, 286, 6, 16, 0.333333
13, 22, 286, 6, 16, 0.333333
19, 16, 232, 5, 11, 0.291667
17, 18, 235, 7, 11, 0.270833
24, 11, 165, 2, 9, 0.319444
19, 16, 239, 6, 10, 0.284722
17, 18, 217, 6, 12, 0.250000
17, 18, 217, 6, 12, 0.250000
24, 11, 152, 5, 6, 0.222222
24, 11, 152, 5, 6, 0.222222
24, 11, 152, 5, 6, 0.222222
21, 14, 164, 5, 9, 0.222222
20, 15, 233, 6, 9, 0.277778
22, 13, 161, 4, 9, 0.298611
19, 16, 189, 5, 11, 0.284722
18, 17, 230, 5, 12, 0.298611
19, 16, 237, 6, 10, 0.250000
19, 16, 237, 6, 10, 0.250000
15, 20, 259, 8, 12, 0.256944
15, 20, 259, 8, 12, 0.256944
15, 20, 259, 8, 12, 0.256944
19, 16, 248, 5, 11, 0.305556
19, 16, 230, 7, 9, 0.243056
17, 18, 250, 3, 15, 0.361111
16, 19, 249, 5, 14, 0.291667
19, 16, 212, 7, 9, 0.236111
20, 15, 191, 5, 10, 0.263889
20, 15, 191, 5, 10, 0.263889
15, 20, 257, 7, 13, 0.263889
15, 20, 257, 7, 13, 0.263889
15, 20, 257, 7, 13, 0.263889
20, 15, 229, 6, 9, 0.256944
22, 13, 177, 6, 7, 0.229167
20, 15, 208, 4, 11, 0.298611
18, 17, 225, 6, 11, 0.277778
19, 16, 265, 6, 10, 0.277778
17, 18, 241, 5, 13, 0.319444
17, 18, 243, 5, 13, 0.319444
14, 21, 300, 9, 12, 0.236111
14, 21, 300, 9, 12, 0.236111
14, 21, 300, 9, 12, 0.236111
16, 19, 217, 6, 13, 0.284722
18, 17, 228, 7, 10, 0.277778
24, 11, 164, 5, 6, 0.229167
23, 12, 185, 7, 5, 0.215278
18, 17, 200, 3, 14, 0.312500
18, 17, 210, 5, 12, 0.256944
22, 13, 196, 5, 8, 0.256944
22, 13, 196, 5, 8, 0.256944
22, 13, 196, 5, 8, 0.256944
19, 16, 246, 5, 11, 0.326389
19, 16, 210, 7, 9, 0.229167
21, 14, 197, 4, 10, 0.298611
18, 17, 207, 6, 11, 0.263889
18, 17, 182, 6, 11, 0.243056
18, 17, 203, 5, 12, 0.263889
18, 17, 203, 5, 12, 0.263889
22, 13, 177, 4, 9, 0.256944
22, 13, 177, 4, 9, 0.256944
22, 13, 177, 4, 9, 0.256944
23, 12, 152, 6, 6, 0.229167
21, 14, 158, 6, 8, 0.250000
20, 15, 239, 4, 11, 0.319444
21, 14, 187, 4, 10, 0.270833
17, 18, 256, 8, 10, 0.243056
20, 15, 208, 5, 10, 0.291667
20, 15, 208, 5, 10, 0.291667
16, 19, 257, 7, 12, 0.250000
16, 19, 257, 7, 12, 0.250000
16, 19, 257, 7, 12, 0.250000
18, 17, 197, 5, 12, 0.270833
20, 15, 206, 6, 9, 0.263889
25, 10, 159, 5, 5, 0.215278
22, 13, 182, 5, 8, 0.256944
23, 12, 163, 3, 9, 0.298611
23, 12, 163, 3, 9, 0.298611
18, 17, 214, 6, 11, 0.277778
18, 17, 214, 6, 11, 0.277778
18, 17, 214, 6, 11, 0.277778
17, 18, 239, 5, 13, 0.291667
18, 17, 202, 8, 9, 0.201389
22, 13, 167, 4, 9, 0.277778
14, 21, 244, 6, 15, 0.284722
14, 21, 244, 6, 15, 0.284722
24, 11, 188, 5, 6, 0.250000
24, 11, 188, 5, 6, 0.250000
24, 11, 188, 5, 6, 0.250000
24, 11, 166, 4, 7, 0.250000
22, 13, 188, 7, 6, 0.250000
21, 14, 215, 4, 10, 0.333333
16, 19, 218, 5, 14, 0.298611
17, 18, 210, 5, 13, 0.284722
17, 18, 212, 5, 13, 0.270833
17, 18, 212, 5, 13, 0.270833
21, 14, 184, 6, 8, 0.229167
21, 14, 184, 6, 8, 0.229167
21, 14, 184, 6, 8, 0.229167
25, 10, 128, 4, 6, 0.250000
21, 14, 167, 7, 7, 0.215278
17, 18, 295, 6, 12, 0.326389
22, 13, 192, 5, 8, 0.284722
18, 17, 237, 6, 11, 0.291667
15, 20, 242, 7, 13, 0.263889
15, 20, 242, 7, 13, 0.263889
15, 20, 242, 7, 13, 0.263889
14, 21, 253, 6, 15, 0.284722
20, 15, 219, 6, 9, 0.236111
18, 17, 227, 6, 11, 0.250000
22, 13, 172, 5, 8, 0.263889
20, 15, 210, 7, 8, 0.243056
18, 17, 206, 4, 13, 0.319444
18, 17, 206, 4, 13, 0.319444
20, 15, 195, 5, 10, 0.270833
20, 15, 195, 5, 10, 0.270833
20, 15, 195, 5, 10, 0.270833
21, 14, 162, 8, 6, 0.201389
22, 13, 189, 6, 7, 0.250000
20, 15, 229, 6, 9, 0.263889
20, 15, 215, 5, 10, 0.256944
15, 20, 262, 8, 12, 0.250000
17, 18, 227, 3, 15, 0.312500
17, 18, 247, 4, 14, 0.312500
21, 14, 208, 4, 10, 0.319444
21, 14, 208, 4, 10, 0.319444
21, 14, 208, 4, 10, 0.319444
17, 18, 273, 5, 13, 0.354167
20, 15, 227, 4, 11, 0.326389
19, 16, 230, 5, 11, 0.291667
20, 15, 207, 7, 8, 0.215278
19, 16, 200, 7, 9, 0.236111
19, 16, 200, 7, 9, 0.236111
19, 16, 223, 6, 10, 0.263889
19, 16, 223, 6, 10, 0.263889
19, 16, 223, 6, 10, 0.263889
21, 14, 189, 5, 9, 0.263889
20, 15, 216, 8, 7, 0.236111
19, 16, 223, 5, 11, 0.298611
18, 17, 221, 5, 12, 0.305556
20, 15, 190, 6, 9, 0.243056
20, 15, 179, 4, 11, 0.291667
20, 15, 179, 4, 11, 0.291667
17, 18, 226, 7, 11, 0.263889
17, 18, 226, 7, 11, 0.263889
17, 18, 226, 7, 11, 0.263889
20, 15, 215, 5, 10, 0.263889
17, 18, 214, 8, 10, 0.243056
20, 15, 208, 8, 7, 0.201389
20, 15, 172, 3, 12, 0.291667
18, 17, 247, 9, 8, 0.208333
17, 18, 221, 7, 11, 0.263889
17, 18, 221, 7, 11, 0.263889
20, 15, 197, 5, 10, 0.270833
20, 15, 197, 5, 10, 0.270833
20, 15, 197, 5, 10, 0.270833
19, 16, 233, 7, 9, 0.236111
20, 15, 207, 5, 10, 0.270833
19, 16, 216, 6, 10, 0.250000
19, 16, 255, 6, 10, 0.256944
19, 16, 219, 6, 10, 0.270833
19, 16, 219, 6, 10, 0.270833
21, 14, 189, 6, 8, 0.250000
21, 14, 189, 6, 8, 0.250000
21, 14, 189, 6, 8, 0.250000
18, 17, 230, 4, 13, 0.312500
17, 18, 215, 8, 10, 0.263889
23, 12, 183, 5, 7, 0.243056
22, 13, 169, 4, 9, 0.256944
17, 18, 267, 8, 10, 0.243056
20, 15, 175, 3, 12, 0.312500
20, 15, 175, 3, 12, 0.312500
18, 17, 232, 4, 13, 0.305556
18, 17, 232, 4, 13, 0.305556
18, 17, 232, 4, 13, 0.305556
17, 18, 221, 3, 15, 0.319444
22, 13, 170, 6, 7, 0.222222
16, 19, 297, 7, 12, 0.270833
19, 16, 216, 7, 9, 0.236111
21, 14, 164, 5, 9, 0.256944
17, 18, 233, 7, 11, 0.263889
17, 18, 233, 7, 11, 0.263889
18, 17, 242, 7, 10, 0.250000
18, 17, 242, 7, 10, 0.250000
18, 17, 242, 7, 10, 0.250000
22, 13, 171, 5, 8, 0.250000
22, 13, 185, 6, 7, 0.243056
22, 13, 204, 5, 8, 0.263889
18, 17, 246, 5, 12, 0.284722
16, 19, 254, 8, 11, 0.250000
23, 12, 151, 3, 9, 0.270833
23, 12, 151, 3, 9, 0.270833
16, 19, 288, 6, 13, 0.319444
16, 19, 288, 6, 13, 0.319444
16, 19, 288, 6, 13, 0.319444
18, 17, 235, 5, 12, 0.284722
17, 18, 225, 7, 11, 0.250000
22, 13, 159, 6, 7, 0.236111
21, 14, 217, 8, 6, 0.229167
16, 19, 243, 7, 12, 0.236111
16, 19, 243, 7, 12, 0.236111
13, 22, 303, 7, 15, 0.277778
13, 22, 303, 7, 15, 0.277778
13, 22, 303, 7, 15, 0.277778
15, 20, 255, 5, 15, 0.312500
21, 14, 166, 6, 8, 0.250000
22, 13, 162, 7, 6, 0.208333
17, 18, 228, 6, 12, 0.263889
17, 18, 228, 6, 12, 0.263889
17, 18, 248, 8, 10, 0.229167
17, 18, 248, 8, 10, 0.229167
17, 18, 248, 8, 10, 0.229167
22, 13, 179, 5, 8, 0.236111
20, 15, 202, 8, 7, 0.215278
20, 15, 209, 5, 10, 0.256944
21, 14, 164, 3, 11, 0.270833
17, 18, 226, 8, 10, 0.243056
19, 16, 214, 6, 10, 0.243056
19, 16, 214, 6, 10, 0.243056
19, 16, 226, 7, 9, 0.236111
19, 16, 226, 7, 9, 0.236111
19, 16, 226, 7, 9, 0.236111
21, 14, 171, 8, 6, 0.208333
21, 14, 210, 6, 8, 0.277778
21, 14, 213, 7, 7, 0.222222
21, 14, 198, 5, 9, 0.263889
19, 16, 200, 7, 9, 0.243056
22, 13, 205, 4, 9, 0.277778
22, 13, 205, 4, 9, 0.277778
19, 16, 194, 6, 10, 0.256944
19, 16, 194, 6, 10, 0.256944
19, 16, 194, 6, 10, 0.256944
18, 17, 287, 7, 10, 0.270833
22, 13, 195, 7, 6, 0.222222
20, 15, 224, 4, 11, 0.284722
19, 16, 209, 4, 12, 0.291667
23, 12, 178, 6, 6, 0.229167
21, 14, 214, 6, 8, 0.222222
21, 14, 214, 6, 8, 0.222222
20, 15, 209, 6, 9, 0.284722
20, 15, 209, 6, 9, 0.284722
20, 15, 209, 6, 9, 0.284722
20, 15, 225, 6, 9, 0.284722
22, 13, 203, 7, 6, 0.270833
21, 14, 229, 4, 10, 0.347222
16, 19, 246, 6, 13, 0.277778
19, 16, 232, 7, 9, 0.236111
20, 15, 208, 4, 11, 0.291667
20, 15, 208, 4, 11, 0.291667
17, 18, 228, 6, 12, 0.270833
17, 18, 228, 6, 12, 0.270833
17, 18, 228, 6, 12, 0.270833
21, 14, 222, 5, 9, 0.277778
23, 12, 175, 6, 6, 0.229167
19, 16, 227, 5, 11, 0.284722
21, 14, 183, 4, 10, 0.284722
18, 17, 306, 7, 10, 0.291667
20, 15, 181, 4, 11, 0.291667
20, 15, 181, 4, 11, 0.291667
20, 15, 195, 4, 11, 0.284722
20, 15, 195, 4, 11, 0.284722
20, 15, 195, 4, 11, 0.284722
15, 20, 268, 8, 12, 0.256944
21, 14, 157, 5, 9, 0.270833
18, 17, 251, 7, 10, 0.250000
19, 16, 232, 7, 9, 0.236111
21, 14, 193, 7, 7, 0.215278
17, 18, 241, 7, 11, 0.270833
17, 18, 241, 7, 11, 0.270833
24, 11, 150, 4, 7, 0.243056
24, 11, 150, 4, 7, 0.243056
24, 11, 150, 4, 7, 0.243056
22, 13, 167, 6, 7, 0.208333
19, 16, 232, 7, 9, 0.256944
23, 12, 165, 4, 8, 0.305556
20, 15, 186, 6, 9, 0.270833
19, 16, 226, 5, 11, 0.277778
20, 15, 195, 5, 10, 0.284722
20, 15, 195, 5, 10, 0.284722
21, 14, 188, 6, 8, 0.250000
21, 14, 188, 6, 8, 0.250000
21, 14, 188, 6, 8, 0.250000
16, 19, 307, 8, 11, 0.250000
21, 14, 216, 3, 11, 0.333333
20, 15, 225, 5, 10, 0.263889
24, 11, 175, 5, 6, 0.250000
22, 13, 199, 5, 8, 0.263889
22, 13, 199, 5, 8, 0.263889
16, 19, 233, 6, 13, 0.284722
16, 19, 233, 6, 13, 0.284722
16, 19, 233, 6, 13, 0.284722
22, 13, 221, 6, 7, 0.256944
18, 17, 221, 4, 13, 0.319444
23, 12, 158, 3, 9, 0.291667
20, 15, 217, 6, 9, 0.229167
20, 15, 217, 6, 9, 0.229167
16, 19, 215, 8, 11, 0.243056
16, 19, 215, 8, 11, 0.243056
16, 19, 215, 8, 11, 0.243056
20, 15, 197, 6, 9, 0.243056
22, 13, 164, 4, 9, 0.270833
16, 19, 250, 5, 14, 0.305556
21, 14, 183, 5, 9, 0.263889
14, 21, 247, 6, 15, 0.291667
14, 21, 247, 6, 15, 0.291667
24, 11, 188, 5, 6, 0.250000
24, 11, 188, 5, 6, 0.250000
24, 11, 188, 5, 6, 0.250000
23, 12, 178, 4, 8, 0.256944
22, 13, 192, 7, 6, 0.250000
21, 14, 232, 4, 10, 0.333333
17, 18, 197, 6, 12, 0.263889
17, 18, 210, 5, 13, 0.284722
17, 18, 227, 8, 10, 0.256944
17, 18, 227, 8, 10, 0.256944
20, 15, 197, 4, 11, 0.312500
20, 15, 197, 4, 11, 0.312500
20, 15, 197, 4, 11, 0.312500
19, 16, 247, 8, 8, 0.222222
20, 15, 219, 5, 10, 0.291667
18, 17, 256, 7, 10, 0.243056
18, 17, 265, 6, 11, 0.277778
19, 16, 197, 6, 10, 0.270833
19, 16, 197, 6, 10, 0.270833
17, 18, 231, 6, 12, 0.270833
17, 18, 247, 6, 12, 0.277778
17, 18, 247, 6, 12, 0.277778
21, 14, 188, 5, 9, 0.270833
20, 15, 233, 8, 7, 0.229167
19, 16, 210, 4, 12, 0.305556
16, 19, 267, 7, 12, 0.270833
21, 14, 217, 7, 7, 0.222222
18, 17, 218, 5, 12, 0.298611
18, 17, 233, 6, 11, 0.277778
16, 19, 253, 7, 12, 0.305556
16, 19, 253, 7, 12, 0.305556
16, 19, 253, 7, 12, 0.305556
22, 13, 170, 6, 7, 0.256944
20, 15, 220, 6, 9, 0.291667
21, 14, 244, 7, 7, 0.236111
21, 14, 213, 5, 9, 0.263889
15, 20, 268, 9, 11, 0.236111
19, 16, 204, 5, 11, 0.256944
19, 16, 204, 5, 11, 0.256944
17, 18, 247, 8, 10, 0.256944
17, 18, 247, 8, 10, 0.256944
17, 18, 247, 8, 10, 0.256944
22, 13, 167, 5, 8, 0.270833
23, 12, 179, 7, 5, 0.236111
24, 11, 189, 6, 5, 0.243056
19, 16, 219, 7, 9, 0.222222
17, 18, 245, 11, 7, 0.187500
15, 20, 246, 9, 11, 0.215278
15, 20, 246, 9, 11, 0.215278
25, 10, 155, 4, 6, 0.243056
25, 10, 155, 4, 6, 0.243056
25, 10, 155, 4, 6, 0.243056
21, 14, 199, 6, 8, 0.236111
19, 16, 222, 7, 9, 0.250000
21, 14, 177, 3, 11, 0.291667
17, 18, 247, 6, 12, 0.277778
16, 19, 220, 6, 13, 0.284722
23, 12, 180, 4, 8, 0.284722
23, 12, 180, 4, 8, 0.284722
18, 17, 187, 6, 11, 0.256944
18, 17, 187, 6, 11, 0.256944
18, 17, 187, 6, 11, 0.256944
22, 13, 212, 4, 9, 0.277778
21, 14, 202, 9, 5, 0.194444
18, 17, 202, 4, 13, 0.284722
19, 16, 223, 5, 11, 0.277778
18, 17, 258, 7, 10, 0.250000
16, 19, 234, 4, 15, 0.319444
16, 19, 234, 4, 15, 0.319444
16, 19, 259, 7, 12, 0.243056
16, 19, 259, 7, 12, 0.243056
16, 19, 259, 7, 12, 0.243056
17, 18, 227, 5, 13, 0.305556
19, 16, 214, 8, 8, 0.250000
23, 12, 184, 4, 8, 0.270833
23, 12, 170, 7, 5, 0.201389
20, 15, 210, 5, 10, 0.284722
20, 15, 210, 5, 10, 0.284722
21, 14, 199, 5, 9, 0.263889
21, 14, 199, 5, 9, 0.263889
21, 14, 199, 5, 9, 0.263889
20, 15, 240, 8, 7, 0.222222
20, 15, 192, 8, 7, 0.201389
24, 11, 206, 4, 7, 0.277778
22, 13, 172, 6, 7, 0.222222
18, 17, 264, 10, 7, 0.201389
18, 17, 216, 5, 12, 0.284722
18, 17, 216, 5, 12, 0.284722
16, 19, 252, 7, 12, 0.270833
16, 19, 252, 7, 12, 0.270833
16, 19, 252, 7, 12, 0.270833
22, 13, 159, 6, 7, 0.236111
23, 12, 182, 7, 5, 0.222222
22, 13, 200, 6, 7, 0.229167
20, 15, 221, 6, 9, 0.243056
18, 17, 229, 8, 9, 0.236111
16, 19, 239, 6, 13, 0.298611
16, 19, 239, 6, 13, 0.298611
24, 11, 163, 5, 6, 0.243056
24, 11, 163, 5, 6, 0.243056
24, 11, 163, 5, 6, 0.243056
20, 15, 225, 7, 8, 0.229167
23, 12, 173, 4, 8, 0.298611
18, 17, 231, 5, 12, 0.291667
19, 16, 249, 8, 8, 0.243056
15, 20, 245, 6, 14, 0.305556
21, 14, 185, 5, 9, 0.277778
21, 14, 185, 5, 9, 0.277778
22, 13, 175, 6, 7, 0.236111
22, 13, 175, 6, 7, 0.236111
22, 13, 175, 6, 7, 0.236111
17, 18, 296, 8, 10, 0.243056
22, 13, 186, 3, 10, 0.298611
21, 14, 201, 4, 10, 0.270833
24, 11, 175, 5, 6, 0.250000
19, 16, 197, 6, 10, 0.236111
19, 16, 197, 6, 10, 0.236111
20, 15, 191, 6, 9, 0.256944
20, 15, 191, 6, 9, 0.256944
20, 15, 191, 6, 9, 0.256944
19, 16, 215, 4, 12, 0.298611
19, 16, 204, 8, 8, 0.215278
19, 16, 214, 7, 9, 0.229167
23, 12, 156, 2, 10, 0.298611
19, 16, 236, 8, 8, 0.270833
23, 12, 153, 2, 10, 0.291667
23, 12, 153, 2, 10, 0.291667
16, 19, 232, 5, 14, 0.305556
16, 19, 232, 5, 14, 0.305556
16, 19, 232, 5, 14, 0.305556
16, 19, 258, 6, 13, 0.277778
24, 11, 163, 6, 5, 0.229167
19, 16, 229, 2, 14, 0.347222
19, 16, 195, 3, 13, 0.312500
17, 18, 247, 7, 11, 0.243056
21, 14, 190, 4, 10, 0.277778
21, 14, 190, 4, 10, 0.277778
17, 18, 211, 6, 12, 0.250000
17, 18, 211, 6, 12, 0.250000
17, 18, 211, 6, 12, 0.250000
18, 17, 235, 5, 12, 0.312500
23, 12, 169, 6, 6, 0.215278
17, 18, 223, 5, 13, 0.284722
19, 16, 209, 6, 10, 0.250000
20, 15, 246, 7, 8, 0.222222
15, 20, 253, 6, 14, 0.291667
15, 20, 253, 6, 14, 0.291667
22, 13, 191, 4, 9, 0.284722
22, 13, 191, 4, 9, 0.284722
22, 13, 191, 4, 9, 0.284722
15, 20, 248, 7, 13, 0.263889
20, 15, 200, 7, 8, 0.229167
18, 17, 232, 6, 11, 0.236111
22, 13, 201, 5, 8, 0.284722
18, 17, 224, 8, 9, 0.215278
22, 13, 184, 4, 9, 0.250000
22, 13, 184, 4, 9, 0.250000
20, 15, 171, 6, 9, 0.256944
20, 15, 171, 6, 9, 0.256944
20, 15, 171, 6, 9, 0.256944
21, 14, 205, 5, 9, 0.284722
22, 13, 196, 6, 7, 0.263889
21, 14, 188, 3, 11, 0.326389
17, 18, 220, 6, 12, 0.243056
21, 14, 180, 5, 9, 0.256944
19, 16, 211, 4, 12, 0.305556
19, 16, 211, 4, 12, 0.305556
13, 22, 296, 8, 14, 0.256944
13, 22, 296, 8, 14, 0.256944
13, 22, 296, 8, 14, 0.256944
18, 17, 201, 6, 11, 0.270833
19, 16, 232, 6, 10, 0.305556
22, 13, 205, 7, 6, 0.229167
17, 18, 223, 5, 13, 0.284722
17, 18, 223, 5, 13, 0.284722
23, 12, 158, 4, 8, 0.256944
23, 12, 158, 4, 8, 0.256944
23, 12, 158, 4, 8, 0.256944
24, 11, 160, 4, 7, 0.277778
19, 16, 203, 8, 8, 0.229167
20, 15, 218, 4, 11, 0.319444
22, 13, 180, 5, 8, 0.256944
18, 17, 221, 8, 9, 0.250000
18, 17, 220, 4, 13, 0.347222
18, 17, 238, 6, 11, 0.270833
16, 19, 257, 6, 13, 0.305556
16, 19, 257, 6, 13, 0.305556
16, 19, 257, 6, 13, 0.305556
22, 13, 167, 6, 7, 0.243056
22, 13, 204, 7, 6, 0.250000
21, 14, 228, 7, 7, 0.222222
21, 14, 215, 5, 9, 0.263889
18, 17, 229, 8, 9, 0.236111
17, 18, 243, 5, 13, 0.312500
17, 18, 234, 6, 12, 0.277778
20, 15, 214, 6, 9, 0.263889
20, 15, 214, 6, 9, 0.263889
20, 15, 214, 6, 9, 0.263889
21, 14, 234, 6, 8, 0.243056
19, 16, 222, 7, 9, 0.277778
19, 16, 238, 6, 10, 0.270833
19, 16, 243, 8, 8, 0.215278
18, 17, 248, 7, 10, 0.256944
17, 18, 205, 7, 11, 0.222222
17, 18, 209, 7, 11, 0.229167
21, 14, 218, 6, 8, 0.256944
21, 14, 218, 6, 8, 0.256944
21, 14, 218, 6, 8, 0.256944
21, 14, 221, 5, 9, 0.277778
20, 15, 205, 6, 9, 0.270833
20, 15, 210, 4, 11, 0.312500
19, 16, 202, 4, 12, 0.298611
15, 20, 234, 5, 15, 0.312500
17, 18, 207, 7, 11, 0.243056
17, 18, 207, 7, 11, 0.243056
25, 10, 146, 5, 5, 0.215278
25, 10, 146, 5, 5, 0.215278
25, 10, 146, 5, 5, 0.215278
22, 13, 179, 7, 6, 0.208333
20, 15, 222, 7, 8, 0.250000
23, 12, 165, 5, 7, 0.270833
20, 15, 194, 7, 8, 0.236111
19, 16, 232, 5, 11, 0.277778
16, 19, 262, 7, 12, 0.256944
16, 19, 262, 7, 12, 0.256944
17, 18, 257, 8, 10, 0.229167
17, 18, 257, 8, 10, 0.229167
17, 18, 257, 8, 10, 0.229167
21, 14, 189, 5, 9, 0.243056
18, 17, 259, 7, 10, 0.263889
19, 16, 265, 4, 12, 0.305556
20, 15, 197, 5, 10, 0.250000
19, 16, 222, 7, 9, 0.229167
19, 16, 232, 6, 10, 0.284722
19, 16, 232, 6, 10, 0.284722
15, 20, 261, 7, 13, 0.243056
15, 20, 261, 7, 13, 0.243056
15, 20, 261, 7, 13, 0.243056
17, 18, 217, 6, 12, 0.256944
19, 16, 242, 7, 9, 0.263889
25, 10, 173, 6, 4, 0.208333
21, 14, 208, 6, 8, 0.250000
17, 18, 202, 8, 10, 0.215278
17, 18, 210, 8, 10, 0.222222
18, 17, 227, 8, 9, 0.250000
17, 18, 245, 9, 9, 0.236111
17, 18, 245, 9, 9, 0.236111
21, 14, 188, 6, 8, 0.256944
21, 14, 155, 7, 7, 0.229167
22, 13, 230, 4, 9, 0.305556
19, 16, 188, 4, 12, 0.305556
16, 19, 242, 11, 8, 0.208333
23, 12, 177, 5, 7, 0.263889
23, 12, 177, 5, 7, 0.263889
20, 15, 192, 6, 9, 0.256944
20, 15, 192, 6, 9, 0.256944
20, 15, 192, 6, 9, 0.256944
22, 13, 198, 4, 9, 0.284722
24, 11, 233, 7, 4, 0.222222
19, 16, 224, 3, 13, 0.319444
22, 13, 196, 4, 9, 0.270833
19, 16, 267, 7, 9, 0.250000
18, 17, 200, 7, 10, 0.229167
18, 17, 200, 7, 10, 0.229167
18, 17, 223, 6, 11, 0.284722
18, 17, 223, 6, 11, 0.284722
18, 17, 223, 6, 11, 0.284722
18, 17, 227, 4, 13, 0.291667
20, 15, 203, 8, 7, 0.215278
21, 14, 180, 5, 9, 0.263889
23, 12, 156, 2, 10, 0.298611
17, 18, 277, 8, 10, 0.270833
